                                                                      
                       .=#%%%%%%%%%%%%%%%%%%%#=                       
                   :%%%%#=.         .....   .+%%%%*.                  
                =%%%*.       +%%%%%%%%%%%%%%%%%#:.#%%%:               
             .%%%=.     .*%%%%%%%%%%%%%%%%%%%%%%%%%%=+%%#.            
           :%%%      .#%%%%%%%%%%%%%%%%%%%%%%%%%%%%%%%%-%%%.          
         .%%*.     :%%%%%%%%%%%%%%%%%%%%%%%%%%%%%%%%%%%%%#%%#         
       .*%%.     :%%%%%%%%%%%%%%%%%%%%%%%%%%%%%%%%%%%%%%%%%#%%=       
       %%=     .%%%%%%%%%%%%%%%%%%%%%%%%%%%%%%%%%%%%%%%%%%%%%#%#      
     :%%.     :%%%%%%%%%%%%%%%%%%%%%%%%%%%%%%%%*++++++++++*#%%%%%     
    .%%      -%%%%%%%%%%%%%%%%%%%%%%%%%%%%%%++++++++++++++++++*%%%.   
   .%%.     -%%%%%%%%%%%%%%%%%%%%%%%%%%%%%++++++++++***+++++++++#%%   
   #%-     .%%%%%%%%%%%%%%%%%%%%%%%%%%%%#++++++*%%%%%%%%%%#++++++*%+  
  :%%      %%%%%%%%%%%%%%%%%%%%%%%%%%%%%++++++%%%%%%%%%%%%%%*+++++%%. 
  #%:     .%%%%%%%%%%%%%%%%%%%%%%%%%%%%%+++++*%%%%%%%%%%%%%%%+++++%%= 
 .%%.     *%%%%%%%%%%%%%%%%%%%%%%%%%%%%%*****#%%%%%%%%%%%%%%#+++++%%% 
 :%#      %%%%%%%%%%%%%%%%%%%%%%%%%%%%%%%%%%%%%%%%%%%%%%%%%*++++++%%% 
 :%#      %%%%%%%%%%%%%%%%%%%%%%%%%%%%%%%%%%%%%%%%%%%##*++++++++++%%% 
 :%#      %%%%%%%%%%%%%%%%%%%%%%%%%%%%%%%%%%%#++++++++++++++++++++%%% 
 .%%      #%%%%%%%%%%%%%%%%%%%%%%%%%%%%%%#++++++++++++++++#%%+++++%%% 
  %%.     +%%%%%%%%%%%%%%%%%%%%%%%%%%%%%+++++++*#%%%%%%%%%%%%+++++%%* 
  +%+     .%%%%%%%%%%%%%%%%%%%%%%%%%%%%++++++%%%%%%%%%%%%%%%%+++++%%: 
   %%.     =%%%%%%%%%%%%%%%%%%%%%%%%%%*+++++%%%%%%%%%%%%%%%%#+++++%#  
   :%#.     #%%%%%%%%%%%%%%%%%%%%%%%%%*++++*%%%%%%%%%%%%%%%%++++++#.  
    +%*     .%%%%%%%%%%%%%%%%%%%%%%%%%*+++++%%%%%%%%%%%%%%*++++++++   
     *%#     .%%%%%%%%%%%%%%%%%%%%%%%%%++++++*%%%%%%%%%#++++++++++++. 
      +%%      #%%%%%%%%%%%%%%%%%%%%%%%%+++++++++++++++++++++#+++++++-
       :%%-     :%%%%%%%%%%%%%%%%%%%%%%%%%+++++++++++++++++#%%%+++++++
         #%%.     =%%%%%%%%%%%%%%%%%%%%%%%%%%#*+++++++**%%%%%+   .-=+=
          .%%%.     -%%%%%%%%%%%%%%%%%%%%%%%%%%%%%%%%%%%#%%#.         
            .#%%=     .*%%%%%%%%%%%%%%%%%%%%%%%%%%%%%%#%%*.           
               =%%%-.     -%%%%%%%%%%%%%%%%%%%%%%%*+%%%-              
                 .=%%%#=.     .:+#%%%%%%%%%%*-:+%%%%-                 
                     .+%%%%%%*=-:....::-=*%%%%%#=                     
                          ..:+%%%%%%%%%%#=...                         